############
#          #
#  ####    #
#     ##   #
#          #
#     ##   #
#          #
############
